  
 Our story starts with me waking one morning. Normally, my morning starts with grabbing the essentials: A breakfast beer, some eggs, maybe checking in on the news grid. This morning however, something is... different.

Last night, I made a mistake. I fell asleep while jacked in and slipping through my company's network. The Ethninicon network is one of the most heavily guarded grid systems out there, and I fell asleep while hunting down some pesky kid beating on the door to one of our systems.

No Carrier Signal
Do your eyes deceive you? by Morgan Gangwere
Release 1 / Serial number 150425 / Inform 7 build 6L38 (I6/v6.33 lib 6/12N) SD

Your apartment.
"Ugh...." I groan as I roll off my futon. "Fuck me and this damn town." Looking down at my Cyberdeck, I notice it's not happy with me; A blinking light and a horrible, nasty sound come from it. 

I figure I might as well get on with my morning. Two problems: No beer (this is a serious fucking problem) and my head feels like someone's put my frontal lobe into an atom smasher.

No use in dawdling here, I need a drink, and for that, it's off to Cyberia.

I can see the door to my apartment and a sidetable (on which are a cellphone and a cyberdeck) here.

>south
(first opening your apartment door)
You rattle the lock, fiddling with the manual side. It doesn't work.

Ring... Ring...

>south
(first opening your apartment door)
Something keeps you from trying the lock. A voice in the back of your head says "Answer the phone, Mr. Hälberg."

Ring... Ring...

>south
(first opening your apartment door)
Something keeps you from trying the lock. A voice in the back of your head says "Answer the phone, Mr. Hälberg."

Ring... Ring...

I beg your pardon?

>answer the phone
A gruff voice on the other end fades in.

"Hello, Mister Hälberg. You don't know me, but I... I know you. I know what you do. I know who you work for. You've checked your door, right? It seems you know things that We want to know."

"You don't know me very well. My name is Mister K. Right now, the Mitsutoya implant in your head is mine." As he says that, your vision goes blank.

"I can make you hear anything," he says, the voice deepening and echoing," I can make you see anything," your vision filled with fire, "and most of all, Mr. Hälberg, I can make you feel anything." Your skin crawls, burning. Pain rushes through your body as you drop to the floor.

"Goodbye, Mr. Hälberg. Come see me in the Osman building, floor 314. You'll know where I am."

Your vision clears. You realize you never picked up the phone: It's sitting tidily on its base, the handset glistening its usual ruby red.
You set down receiver.

* * *

>south
(first opening your apartment door)
Something keeps you from trying the lock. A voice in the back of your head says "Answer the phone, Mr. Hälberg."

Ring... Ring...

>answer phone
A gruff voice on the other end fades in.

"Hello, Mister Hälberg. You don't know me, but I... I know you. I know what you do. I know who you work for. You've checked your door, right? It seems you know things that We want to know."

"You don't know me very well. My name is Mister K. Right now, the Mitsutoya implant in your head is mine." As he says that, your vision goes blank.

"I can make you hear anything," he says, the voice deepening and echoing," I can make you see anything," your vision filled with fire, "and most of all, Mr. Hälberg, I can make you feel anything." Your skin crawls, burning. Pain rushes through your body as you drop to the floor.

"Goodbye, Mr. Hälberg. Come see me in the Osman building, floor 314. You'll know where I am."

Your vision clears. You realize you never picked up the phone: It's sitting tidily on its base, the handset glistening its usual ruby red.
You set down receiver.

>south
(first opening your apartment door)
You shouldn't leave without your cellphone.

>take phone, clothes
Playercellphone: Taken.
your clothes: Taken.

>wear clothes
You can't wear that!

>south
(first opening your apartment door)
You shouldn't leave without your cellphone.

>i
You are carrying:
  your clothes
  a Playercellphone

* * *

>take phone, wear clothes
You can't see any such thing.

>take phone
(the cellphone)
Taken.

>take clothes
Taken.

>wear clothes
You can't wear that!

* * *

>about
That's not a verb I recognise.

>help
That's not a verb I recognise.

* * *

>open door
You rattle the lock, fiddling with the manual side. It doesn't work.

Ring... Ring...

>answer the phone
A gruff voice on the other end fades in.

"Hello, Mister Hälberg. You don't know me, but I... I know you. I know what you do. I know who you work for. You've checked your door, right? It seems you know things that We want to know."

"You don't know me very well. My name is Mister K. Right now, the Mitsutoya implant in your head is mine." As he says that, your vision goes blank.

"I can make you hear anything," he says, the voice deepening and echoing," I can make you see anything," your vision filled with fire, "and most of all, Mr. Hälberg, I can make you feel anything." Your skin crawls, burning. Pain rushes through your body as you drop to the floor.

"Goodbye, Mr. Hälberg. Come see me in the Osman building, floor 314. You'll know where I am."

Your vision clears. You realize you never picked up the phone: It's sitting tidily on its base, the handset glistening its usual ruby red.
You set down receiver.

>open door
You shouldn't leave without your cellphone.

>take phone
(the cellphone)
Taken.

>open door
You shouldn't leave without your cellphone.

* * *

>take phone
(the cellphone)
Taken.

>open door
You rattle the lock, fiddling with the manual side. It doesn't work.

Ring... Ring...

>answer phone
A gruff voice on the other end fades in.

"Hello, Mister Hälberg. You don't know me, but I... I know you. I know what you do. I know who you work for. You've checked your door, right? It seems you know things that We want to know."

"You don't know me very well. My name is Mister K. Right now, the Mitsutoya implant in your head is mine." As he says that, your vision goes blank.

"I can make you hear anything," he says, the voice deepening and echoing," I can make you see anything," your vision filled with fire, "and most of all, Mr. Hälberg, I can make you feel anything." Your skin crawls, burning. Pain rushes through your body as you drop to the floor.

"Goodbye, Mr. Hälberg. Come see me in the Osman building, floor 314. You'll know where I am."

Your vision clears. You realize you never picked up the phone: It's sitting tidily on its base, the handset glistening its usual ruby red.
You set down receiver.

>open door
The door swings open.

>look
Your apartment.
A studio apartment. You try your best to try and maintain some amount of stable entropy. You don't spend much time here anyway.

You can see your apartment door (open, leading south), an unkept bed and a sidetable (on which is a cyberdeck) here.

>south
Apartment Hallway
You stand in a grungy, beaten-down corridor. It was once meant to be fairly futuristic, with paneled walls made of brushed steel, but the years of grime have really gotten to it. To the west is the atrium, to the north your apartment.

You can see the door to your apartment (#A45), A46 and A44 here.

* * *

>take phone
(the cellphone)
Taken.

>south
(first opening your apartment door)
You rattle the lock, fiddling with the manual side. It doesn't work.

Ring... Ring...

>answer phone
A gruff voice on the other end fades in.

"Hello, Mister Hälberg. You don't know me, but I... I know you. I know what you do. I know who you work for. You've checked your door, right? It seems you know things that We want to know."

"You don't know me very well. My name is Mister K. Right now, the Mitsutoya implant in your head is mine." As he says that, your vision goes blank.

"I can make you hear anything," he says, the voice deepening and echoing," I can make you see anything," your vision filled with fire, "and most of all, Mr. Hälberg, I can make you feel anything." Your skin crawls, burning. Pain rushes through your body as you drop to the floor.

"Goodbye, Mr. Hälberg. Come see me in the Osman building, floor 314. You'll know where I am."

Your vision clears. You realize you never picked up the phone: It's sitting tidily on its base, the handset glistening its usual ruby red.
You set down receiver.

>answer phone
<beep beep beep...>You set down receiver.

>south
(first opening your apartment door)
The door swings open.

You close the door behind you

>look
Apartment Hallway
You stand in a grungy, beaten-down corridor. It was once meant to be fairly futuristic, with paneled walls made of brushed steel, but the years of grime have really gotten to it. To the west is the atrium, to the north your apartment.

You can see the door to your apartment (#A45, to the north), A46 and A44 here.

>north
(first opening the door to your apartment (#A45, to the north))
The door swings open.

Your apartment.
A studio apartment. You try your best to try and maintain some amount of stable entropy. You don't spend much time here anyway.

You can see your apartment door (open, leading south), an unkept bed and a sidetable (on which is a cyberdeck) here.

>south
You close the door behind you

>look
Apartment Hallway
You stand in a grungy, beaten-down corridor. It was once meant to be fairly futuristic, with paneled walls made of brushed steel, but the years of grime have really gotten to it. To the west is the atrium, to the north your apartment.

You can see the door to your apartment (#A45, to the north), A46 and A44 here.

>w
Apartment Atrium
A wide-open atrium, coated once again in grungy, nasty steel. To the east is the hallway, to the south lies the street.

a helper robot

>x robot
A rather useless robot which is absorbed in making toast.

>x toast
You can't see any such thing.

>s
Mansk Downtown
Downtown Mansk: Beaten down and nearly in rubble. To the south lies the old Museum of Mansk, to the east, more downtown. Mansk's towering Osman building spears out among the generally smaller office buildings and hotels.

>e
Central Mansk Downtown
Mansk's central district, the core downtown is filled with run-down shops. To the North looms the massive Osman building, one of the few mega-complexes around.

>n
Osman Building
The Osman building towers above. To the south is much of Mansk's central downtown.

>i
You are carrying:
  a cellphone
  a shirt (being worn)
  baggy pants (being worn)
  a pair of shoes (being worn)

>in
Osman Building First Floor

>look
Osman Building First Floor

>in elevator
I only understood you as far as wanting to (go) in.

>in
Osman Building Elevator
You can see a Button Panel here.

>use panel
You will have to be more specific about your intentions.

* * *

>take phone
(the cellphone)
Taken.

>i
I am carrying:
  a cellphone
  a shirt (being worn)
  baggy pants (being worn)
  a pair of shoes (being worn)

>l
Your apartment.
I stand in my studio apartment. It's not much, but for what I get paid, it's pretty damn lavish. I really should clean more often.

I can see the door to my apartment and a sidetable (on which is a cyberdeck) here.

>s
(first opening the door to my apartment)
I figure I should go south to Cyberia for a beer. The lock on my door doesn't totally work
Ring... Ring...

>s
(first opening the door to my apartment)
I keep fiddling with the lock. A voice in my head tells me to answer the phone. It's rather upset at me.

Ring... Ring...

>s
(first opening the door to my apartment)
I keep fiddling with the lock. A voice in my head tells me to answer the phone. It sounds irritated like a mother at a belligerent child.

Ring... Ring...

>s
(first opening the door to my apartment)
I keep fiddling with the lock. A voice in my head tells me to answer the phone. It wants me dead.

Ring... Ring...

>s
(first opening the door to my apartment)
I keep fiddling with the lock. A voice in my head tells me to answer the phone. (Dear player, please answer the goddamn phone)
Ring... Ring...

>answer phone
A gruff voice on the other end fades in.

"Hello, Mister Hälberg. You don't know me, but I... I know you. I know what you do. I know who you work for. You've checked your door, right? It seems you know things that We want to know."

I gawk quietly, unable to speak for myself.

"You don't know me very well. My name is Mister K. Right now, the Mitsutoya implant in your head is mine." My mind goes numb. I struggle to stand, shifting from side to side as my vision goes pitch black.

"I can make you hear anything," he says, the voice becoming ominous, rattling in my head, "I can make you see anything," my head filling with the vision of fire surrounding me, my brain racing, panicing, "and most of all, Mr. Hälberg, I can make you feel anything." I drop to the floor; I would scream if I had a voice, my skin crawling as though a thousand millipedes crawled beneath my skin.

"Goodbye, Mr. Hälberg. Come see me in the Osman building. You'll know where I am."

And with that, my conciousness slammed into me like a meteor coming in for impact. Scrambling, I look at the phone. It's still on its receiver, happily glistening in the light of the dingy old incandescents.

>take cheese
I can't see any such thing.

* * *

>take all
cellphone: Taken.
cyberdeck: Not really useful right now.
Ono-Sendai subscription card: You pull out the calling card. The text "JØV HÄLBERG:2125554240" is punched into the plastic. You place it back into the Cyberdeck.

>i
You are carrying:
  a cellphone
  an unkept bed
  a shirt (being worn)
  baggy pants (being worn)
  a pair of shoes (being worn)

* * *

>take all
cellphone: Taken.
cyberdeck: Not really useful right now.
Ono-Sendai subscription card: You pull out the calling card. The text "JØV HÄLBERG:2125554240" is punched into the plastic. You place it back into the Cyberdeck.

>take bed
That's hardly portable.

>i
You are carrying:
  a cellphone
  a shirt (being worn)
  baggy pants (being worn)
  a pair of shoes (being worn)

>s
(first opening your apartment door)
You rattle the lock, fiddling with the manual side. It doesn't work.

Ring... Ring...

>answer phone
A gruff voice on the other end fades in.

"Hello, Mister Hälberg. You don't know me, but I... I know you. I know what you do. I know who you work for. You've checked your door, right? It seems you know things that We want to know."

"You don't know me very well. My name is Mister K. Right now, the Mitsutoya implant in your head is mine." As he says that, your vision goes blank.

"I can make you hear anything," he says, the voice deepening and echoing," I can make you see anything," your vision filled with fire, "and most of all, Mr. Hälberg, I can make you feel anything." Your skin crawls, burning. Pain rushes through your body as you drop to the floor.

"Goodbye, Mr. Hälberg. Come see me in the Osman building, floor 314. You'll know where I am."

Your vision clears. You realize you never picked up the phone: It's sitting tidily on its base, the handset glistening its usual ruby red.
You set down receiver.

>s
(first opening your apartment door)
The door swings open.

You close the door behind you

>s
(first opening A46)
The door swings open.

>s
(first opening A46)
The door swings open.

>look
Apartment Hallway
You stand in a grungy, beaten-down corridor. It was once meant to be fairly futuristic, with paneled walls made of brushed steel, but the years of grime have really gotten to it. To the west is the atrium, to the north your apartment.

You can see the door to your apartment (#A45, to the north), A46 and A44 here.

* * *

>s
(first opening the door to my apartment)
I figure I should go south to Cyberia for a beer. Trying to unlock the door, I find that something is jamming the mechanism. Fuck!

Ring... Ring...

>answer phone
A gruff voice on the other end fades in.

"Hello, Mister Hälberg. You don't know me, but I... I know you. I know what you do. I know who you work for. It seems you know things that We want to know."

I gawk quietly, unable to speak for myself.

"You don't know me very well. My name is Mister K. Right now, the Mitsutoya implant in your head is mine." My mind goes numb. I struggle to stand, shifting from side to side as my vision goes pitch black.

"I can make you hear anything," he says, the voice becoming ominous, rattling in my head, "I can make you see anything," my head filling with the vision of fire surrounding me, my brain racing, panicing, "and most of all, Mr. Hälberg, I can make you feel anything." I drop to the floor; I would scream if I had a voice, my skin crawling as though a thousand millipedes crawled beneath my skin.

"Goodbye, Mr. Hälberg. Come see me in the Osman building. You'll know where I am."

And with that, my conciousness slammed into me like a meteor coming in for impact. Scrambling, I look at the phone. It's still on its receiver, happily glistening in the light of the dingy old incandescents.

>s
(first opening your apartment door)
You shouldn't leave without your cellphone.

>take phone
(the cellphone)
Taken.

>s
(first opening your apartment door)
The door swings open.

You close the door behind you

>s
(first opening A46)
That's not your apartment.

>e
(first opening A44)
That's not your apartment.

>w
Apartment Atrium
A wide-open atrium, coated once again in grungy, nasty steel. To the east is the hallway, to the south lies the street.

a helper robot

* * *

>take phone
(the cellphone)
Taken.

>s
(first opening the door to my apartment)
The door swings open.

You close the door behind you

>l
Apartment Hallway
You stand in a grungy, beaten-down corridor. It was once meant to be fairly futuristic, with paneled walls made of brushed steel, but the years of grime have really gotten to it. To the west is the atrium, to the north your apartment.

I can see the door to my apartment, A46 and A44 here.

* * *

>take cellphone
Taken.

>s
(first opening the door to my apartment)
The door swings open.

Apartment Hallway
You stand in a grungy, beaten-down corridor. It was once meant to be fairly futuristic, with paneled walls made of brushed steel, but the years of grime have really gotten to it. To the west is the atrium, to the north your apartment.

I can see the door to my apartment, A46 and A44 here.

>close door
I close the door to my apartment.

>w
Apartment Atrium
A wide-open atrium, coated once again in grungy, nasty steel. To the east is the hallway, to the south lies the street.

a helper robot obsesses over some bread

>s
Mansk Downtown
Downtown Mansk: Beaten down and nearly in rubble. To the south lies the old Museum of Mansk, to the east, more downtown.The Osman building is the tallest thing in this shithole; Built by one of the universities, it was meant to take a damn nuke.

>s
Museum of Mansk
Old, crumbling museum courtyard. A set of stairs leads up to the entrance. To the south, a nightclub called Cyberia, in the ruins of what was once a small cluster of houses and shops.

>s
Cyberia
A dingy nightclub. During the day, they keep the lights low. Tables litter the area, a bar at the back.

The Cyberia bar stands at the back. Neon reflects off the wood bartop.

Malroy, the bartender, stands behind the bar. Malroy has come to your aide in the past.

A lone barstool sits before the bar.

>n
Museum of Mansk
Old, crumbling museum courtyard. A set of stairs leads up to the entrance. To the south, a nightclub called Cyberia built by someone who had a whole lot of willpower..

>n
Mansk Downtown
Downtown Mansk: Beaten down and nearly in rubble. To the south lies the old Museum of Mansk, to the east, more downtown.This whole damn city has nothing left in it after the war.

>l
Mansk Downtown
Downtown Mansk: Beaten down and nearly in rubble. To the south lies the old Museum of Mansk, to the east, more downtown.The buildings were once astounding works of art. Now, they're mostly brick, the result of "humanitarian" aid after the war.

>l
Mansk Downtown
Downtown Mansk: Beaten down and nearly in rubble. To the south lies the old Museum of Mansk, to the east, more downtown.The clouds on the horizon smell of rain.

>l
Mansk Downtown
Downtown Mansk: Beaten down and nearly in rubble. To the south lies the old Museum of Mansk, to the east, more downtown.The Osman building is the tallest thing in this shithole; Built by one of the universities, it was meant to take a damn nuke.

>l
Mansk Downtown
Downtown Mansk: Beaten down and nearly in rubble. To the south lies the old Museum of Mansk, to the east, more downtown.This whole damn city has nothing left in it after the war.

>l
Mansk Downtown
Downtown Mansk: Beaten down and nearly in rubble. To the south lies the old Museum of Mansk, to the east, more downtown.The buildings were once astounding works of art. Now, they're mostly brick, the result of "humanitarian" aid after the war.

* * *

>l
Mansk Downtown
Downtown Mansk: Beaten down and nearly in rubble. To the south lies the old Museum of Mansk, to the east, more downtown.The clouds on the horizon smell of rain.

>n
Apartment Atrium
A wide-open atrium, coated once again in grungy, nasty steel. To the east is the hallway, to the south lies the street.

a helper robot obsesses over some bread

>w
I can't go that way.

>e
Apartment Hallway
You stand in a grungy, beaten-down corridor. It was once meant to be fairly futuristic, with paneled walls made of brushed steel, but the years of grime have really gotten to it. To the west is the atrium, to the north your apartment.

I can see the door to my apartment, A46 and A44 here.

* * *

>hit myself
Violence isn't the answer to this one.

>yell
That's not a verb I recognise.

>open door
I figure I should go south to Cyberia for a beer. The lock on my door doesn't totally work
Ring... Ring...

>open door
I keep fiddling with the lock. A voice in my head tells me to answer the phone. It's rather upset at me.

Ring... Ring...

>open door
I keep fiddling with the lock. A voice in my head tells me to answer the phone. It's upset at me, irritated like a mother at a belligerent child.

Ring... Ring...

>open door
I keep fiddling with the lock. A voice in my head tells me to answer the phone. It wants me dead.

Ring... Ring...

>open door
I keep fiddling with the lock. A voice in my head tells me to answer the phone. It wants me dead.

Ring... Ring...

* * *

>l
Your apartment.
I stand in my studio apartment. It's not much, but for what I get paid, it's pretty damn lavish. I really should clean more often.

I can see the door to my apartment and a sidetable (on which are a cellphone and a cyberdeck) here.

>l
Your apartment.
I stand in my studio apartment. It's not much, but for what I get paid, it's pretty damn lavish. I really should clean more often.

I can see the door to my apartment and a sidetable (on which are a cellphone and a cyberdeck) here.

>s
(first opening the door to my apartment)
I figure I should go south to Cyberia for a beer. The lock on my door doesn't totally work
Ring... Ring...

>answer phone
A gruff voice on the other end fades in.

"Hello, Mister Hälberg. You don't know me, but I... I know you. I know what you do. I know who you work for. It seems you know things that We want to know."

I gawk quietly, unable to speak for myself.

"You don't know me very well. My name is Mister K. Right now, the Mitsutoya implant in your head is mine." My mind goes numb. I struggle to stand, shifting from side to side as my vision goes pitch black.

"I can make you hear anything," he says, the voice becoming ominous, rattling in my head, "I can make you see anything," my head filling with the vision of fire surrounding me, my brain racing, panicing, "and most of all, Mr. Hälberg, I can make you feel anything." I drop to the floor; I would scream if I had a voice, my skin crawling as though a thousand millipedes crawled beneath my skin.

"Goodbye, Mr. Hälberg. Come see me in the Osman building. You'll know where I am."

And with that, my conciousness slammed into me like a meteor coming in for impact. Scrambling, I look at the phone. It's still on its receiver, happily glistening in the light of the dingy old incandescents.

>s
(first opening the door to my apartment)
I pause -- I'm missing something... Where did I leave my cellphone?

>take phone
(the cellphone)
Taken.